   NO  ./path_to_1_north_texture
SO ./path_to_the_west_texture
WE        ./path_to_the_west_texture
EA     ./path_to_the_east_texture





C    225,30,0
F        220,16,2


111111111111111111111
101000001000000000001
101010101011111110001
100010100010000010001
101000100000100010101
101011111111111010101
100010000000000010001
101010111011111111101
1N1000001000000000001
111111111111111111111