NO ./textures/Mona_Lisa.png
SO ./textures/Wheat_Field.png
WE ./textures/the_starry_night.png
EA ./textures/girl_with_a_pearl_earring.png 



C 0,0,0
F 255,0,0


			11111111111111111111111111
	100000000011100000000000001
11111111111111111111111111
100100000001000000N0000011111111
111111111011000001110000000000001
10000000001100000111011111111111111
11110111111111011100000010001
11110111111111011101010010001
11000000110101011100000010001
10000000000000001100000010001
10000000000000001101010010001
1100000111010101111101111000111
11110111 10110101 11111010001
11111111 1111111 111111111111