NO ./textures/pp.png
SO ./textures/pp.png
WE ./textures/pp.png
EA ./textures/pp.png


F 80,80,80
C 0,255,255

        1111111111111111111111111
        1000000000110000000000001
        1011000001110000000000001
        1001000000000000000000001
111111111011000001110000000000001
100000000011000001110111101111111
11110111111111011100000010001
11110111111111011101010010001
11000000110101011100000010001
10000000000000001100000010001
10000000000000001101010010001
11000001110101011111011111N11
11110111 1110101 101111010101
11111111 1111111 111111111111
