NO ./textures/hehe.png
SO ./textures/hehe.png
WE ./textures/pp.png
EA ./textures/pp.png


F 0,100,0

C 0,81,170




1111111111111111111
10000000000000000N1
1111111111111111111
